11111111111
111000E1111
11111011111
10000011111
1C111011111
11P00000C11
11111111111